# # # #        
# x   #        
# #   #        
#     #        
#     # # # # #
#             #
# # # # # #   #
#             #
#   # # # # # #
#   #          
# # #          