# # # # # # # # # # # # # #
#     # # #               #
# x       #   # # # # # # #
# # # #   #   # # # # # # #
#         #               #
#   # # # # # # # # # #   #
#                         #
# # # # # # # # # # # # # #