# # # # # # # # #
# x             #
# # #   #       #
#   #   #       #
# # # # # # #   #
#               #
#   # # # # # # #
#               #
# # # # # # #   #
#               #
#               #
# # # # # # # # #