# # # # # # # # # # # # # # # # # # # # # # # # # # # # # # # # # # # # #
#                                                                       #
#                                                                       #
#                                                                       #
#                                                                       #
#                 x                                                     #
#                                                                       #
#                                                                       #
#                                                                       #
#                                                                       #
#                                                                       #
# # # # # # # # # # # # # # # # # # # # # # # # # # # # # # # # # # # # #